11111111
1011C1C1
1C0000C1
1010C001
1111P111
11C00001
10EC01X1
11111111
