111111111111111
10X0000X000X001
111C01110X001X1
1P000X0000001X1
110111111111001
10000111X10XE11
111100000000011
111111111111111
