111111111111111111
1X0CP00000000000X1
10E01C001111100001
10001C001CCCC00001
10001C001000000001
10001C0X1X00000001
100011111111100001
1000000X1X0C100001
10000000100C100001
1000CCCC100C100001
10001111100C100001
1X00000000000000X1
111111111111111111